7.ox
o......o..ooo.o
o.o.oo...o...o.
.o.........oo..
o.oo.o....o....
....o..o...o..o
o..o....o....o.
oo....o...ooo..
